{
  "levels": [
    {
      "rows": 5,
      "columns": 8,
      "data": [
        [1, 0, 2, 0, 2, 0, 0, 1],
        [1, 0, 1, 1, 0, 1, 0, 2],
        [3, 3, 0, 1, 1, 0, 3, 2],
        [0, 2, 0, 1, 1, 2, 0, 3],
        [0, 0, 1, 1, 1, 0, 0, 0]
      ]
    },
    {
      "rows": 4,
      "columns": 8,
      "data": [
        [2, 2, 2, 2, 2, 2, 2, 2],
        [1, 0, 1, 0, 1, 0, 1, 0],
        [0, 1, 0, 1, 0, 1, 0, 1],
        [1, 0, 1, 0, 1, 0, 1, 1]
      ]
    },
    {
      "rows": 6,
      "columns": 9,
      "data": [
        [1, 1, 1, 2, 2, 1, 1, 1, 1],
        [3, 3, 0, 1, 1, 0, 3, 3, 1],
        [2, 0, 1, 1, 1, 1, 0, 2, 2],
        [1, 1, 1, 2, 2, 1, 1, 1, 1],
        [3, 0, 3, 1, 1, 3, 0, 3, 2],
        [1, 1, 2, 0, 2, 1, 1, 1, 1]
      ]
    },
    {
      "rows": 5,
      "columns": 7,
      "data": [
        [3, 3, 1, 1, 1, 3, 3],
        [1, 2, 2, 0, 2, 2, 1],
        [1, 1, 1, 1, 1, 1, 1],
        [2, 0, 2, 2, 2, 0, 2],
        [3, 1, 1, 0, 1, 1, 3]
      ]
    },
    {
      "rows": 4,
      "columns": 10,
      "data": [
        [1, 1, 1, 2, 2, 2, 1, 1, 1, 1],
        [3, 0, 3, 1, 1, 1, 3, 0, 3, 2],
        [2, 1, 0, 1, 1, 1, 0, 1, 2, 2],
        [3, 3, 1, 2, 2, 2, 1, 3, 3, 3]
      ]
    }
  ]
}
