{
  "levels": [
    {
      "rows": 5,
      "columns": 8,
      "data": [
        [1, 1, 2, 1, 2, 1, 1, 0],
        [1, 1, 1, 1, 2, 1, 1, 2],
        [3, 3, 1, 1, 1, 3, 3, 2],
        [0, 2, 1, 1, 1, 2, 0, 3],
        [0, 0, 1, 1, 1, 0, 0, 2]
      ]
    },
    {
      "rows": 4,
      "columns": 8,
      "data": [
        [2, 2, 2, 2, 2, 2, 2, 2],
        [1, 0, 1, 0, 1, 0, 1, 0],
        [0, 1, 0, 1, 0, 1, 0, 1],
        [1, 1, 1, 1, 1, 1, 1, 1]
      ]
    }
  ]
}
